--------------------------------------------------------
--------------------------------------------------------
--------------------------------------------------------
-------------------SSSSSS-S-------SSSSSSSSSSS-------S-S-
--------------------------------------------------------
--------------------------------------------------------
------#----!!--!!-----------!!!!!--------------!!-------
------#-------------------------------------------------
------##-------------------------------#--------------##
-----###---------------------------------------------###
----##---------------------tt------------------------###
--#####-#-----------#---#------k---###--#----------#####
--#######---------####--#--t------####--#--*------######
-######-#--------#####--#--t*----#####--#--*-----#######
XXXXXXXXXXXXXXXXXXXXXXXXXXXXXXXXXXXXXXXXXXXXXXXXXXXXXXXX
XXXXXXXXXXXXXXXXXXXXXXXXXXXXXXXXXXXXXXXXXXXXXXXXXXXXXXXX